##########
#S#      #
#   #### #
# # #### #
# # ##   #
# ## # # #
#  #   # #
## # #####
#  #    E#
##########